1,1,1,1,1,1,1,1,1,1
1,1,1,1,1,1,1,1,1,1
1,1,1,1,1,1,1,1,1,1
1,1,1,1,1,1,1,1,1,1
1,1,1,1,1,1,1,1,1,1
1,1,1,1,1,1,1,1,1,1
1,1,1,1,1,1,0,1,1,1
-2f,-2f,-2f,-2f,-2f,-2f,-2f,-2f,-2f,-2f
-6,-6,-6,-6,-6,-6,-6,-6,-6,-6